10.ox
.........o
.......ooo
..x.......
.....o....
..........
.........o
..........
..........
..........
..........
